########################
#P.#...#...#...........#
#..#...#...#...XXXX....#
#....C...C.....####....#
######.###########.....#
#................#.....#
#...C............#.....#
#.......##########.....#
#.......#..............#
#####...#....C.........#
#.......#..............#
########################