########################
#P..........####X......#
#....C......####......X#
#...........####.......#
######.#########.......#
#......................#
#....C.................#
#......................#
#....C...........#######
#......#...............#
#.X....#...............#
########################