######
#PEEE#
##ECE#
#EEEE#
######