########################
#P.#...#...#......XXXXX#
#..#...#...#...C...#####
#....C...C.............#
######.###########.....#
#................#.....#
#...C............#.....#
#.......##########.....#
#.......#..............#
#####...#....C.........#
#.......#..............#
########################