###################################
#P#...#........#..........#.....O.#
#.#.F.#..XXX...#..SSSSSS..#..F....#
#........XXX...M..SSSSSS..M.......#
###.###..XXX...#..........#.#######
#.......##M#####..######..#.......#
#..C....##L..SSS.SSS...#..#....C..#
#####.####..SSSSSSSSS..#####.######
#........#..SSSSSSSSS..#..........#
#........M..SSSS.SSSS..M...F...C..#
#........#..SSSSSSSSS..#..........#
######.###..##########.####.#######
#........#..#........#.############
#........M..M........M.M..........#
#........#..#........#.#..........#
#......Z....M....C...M.M.......C..#
#........#..#........#.#..........#
###################################