###################
#P................#
##.C..............#
#.................#
###################